являться: являться
арка: аркой
общий: общий общем общему общей
колонна: колонны колонна колонн колоннами колонну
пороховой: порохового пороховым
сражение: сражения сражении сражению сражением сражение сраженье
сын: сын сына сыну сыном
царствование: царствование
слабо: слабо
польша: польше
врасплох: врасплох
прозвание: прозванию
суетня: суетня
показаться: показалось показался показались
послать: послал послано посланный послать пошлют
пора: пор
губка: губкой губке губка
ольмюца: ольмюца ольмюц
ночь: ночи ночь
домашний: домашними
ясный: ясный яснее
довести: доведен
пуля: пулей пуля
преображенец: преображенцев
князь: князя князе князю князем князь
присоединиться: присоединившиеся
позволить: позволите
бонапарт: бонапарта бонапарте
торжественный: торжественным торжественного
бархатный: бархатным
придворный: придворных
искусство: искусства
артиллерийский: артиллерийской
выгода: выгоду
больничный: больничных больничном
мнение: мнение мнении
лежать: лежали лежал лежавшую лежала
сам: сами самому самом самого самим сам
тулон: тулона
слабый: слабее слабым
оставаться: оставались оставалась оставалось остающимся оставался оставаться
недоброжелательный: недоброжелательные
стать: стал стали стало стала
смеркнуться: смерклось
австрийский: австрийских австрийским австрийский австрийского австрийскими австрийские
судить: судя
московский: московскому московские
отчий: отчего
собираться: собирались
ряд: рядам ряды
заказ: заказа
взад: взад
детство: детства
приблизить: приблизил приближенные
государственный: государственного государственная государственных
офицерский: офицерские офицерских
publique: publique
узнать: узнав узнал узнай
отпуск: отпуска
княжна: княжною княжну княжны княжна княжон
изливать: изливать
неизвестный: неизвестная неизвестное неизвестные
август: августе
глубокий: глубокое
порох: порохом
огромный: огромном огромный огромного огромное огромных
представлять: представлял
окружающий: окружающие окружающими
спираться: спираясь
перекатный: перекатная
погребец: погребец
улица: улице
быть: была был были было быть будет будь
внимание: внимание внимания
круто: круто
спальня: спальню
возбуждать: возбуждал
сюртук: сюртук
музыка: музыки
стоять: стоявшая стоял стоявшего стояла стояло стояли стоят
говорить: говоря говорило говорить говорил говорили говорила говорит
объезжать: объезжая
правление: правления
полный: полным полную полон
xiv: xiv
поглядывать: поглядывая
алгебра: алгебры
порядок: порядке порядка порядок
бледный: бледный
сообщение: сообщений сообщения сообщение
положить: положен положил
обложить: обложенном
духовный: духовные
уважать: уважали уважать
выразить: выразить
сперанский: сперанский сперанским сперанского
повернуть: повернул
орудие: орудиями орудий орудия
понимать: понимаете понимал понимая понимала
эрцгерцогство: эрцгерцогства
манера: манера
узнавать: узнавал узнавать
гусар: гусары гусар
занять: занять
блестеть: блестит
второстепенный: второстепенное
батальонный: батальонные
завладеть: завладел
лощина: лощины лощине
отрываться: отрывался
тильзита: тильзит
осветить: освещена освещены освещенной освещенными
справедливый: справедлива
солнечный: солнечный
соединение: соединении соединение
резерв: резервов резерве
охотно: охотно
тридцатипятитысячный: тридцатипятитысячная
французский: французскою французский французские французскими французского французском французской французских
руководительница: руководительницей
царский: царская
божий: божий божией
кутузов: кутузов кутузова кутузову кутузовым
зарево: зарево
расстроить: расстроенных расстроен
беспорядочный: беспорядочными
главный: главная главной главные главный главному
число: числом числе числа
послышаться: послышались
предоставить: предоставлен
дело: дел делах дело дела делами делом делам деле
кожаный: кожаный
ревизия: ревизию
новый: новую нового новые новое новой новый ново новых
эрфурт: эрфурт
безухов: безухову безухов безухова безуховым
пожар: пожар пожаров
оживлённо: оживленно
цвет: цветов
такой: такого таких такой такая такую такое такие таким
воспитание: воспитанием
дух: духа
въезжать: въезжавшую въезжала
проходить: проходившие проходила
блеск: блеск
щемить: щемило
неделя: недели неделю
москва: москве москвы москва москву
хороший: хорошем лучшая лучшее лучших лучшие лучшим лучший наилучшее
ожидать: ожидало ожидали ожидать ожидала ожидал ожидая
насколько: насколько
служить: служили служил
выказать: выкажи
полуверста: полуверсты
знаменитый: знаменитую знаменитым знаменитые
несамоуверенный: несамоуверенный
знать: знал знали знала зная знаю знавшей
лошадь: лошади лошадьми лошадь лошадей
представляться: представляться представлялся представлявшееся представлявшаяся
дать: дали дана даст дам дать
верста: верст версты верстах
два: два двух двумя две
она: нею она ей нее ее ней
ядро: ядра ядро ядер
пить: пили пил
находиться: находилась находился находилось находились
барышня: барышни
милостыня: милостыни
подвинуться: подвинувшееся подвинулась
гвардия: гвардия гвардии
испуганный: испуганными испуганным
долгоруков: долгорукову долгорукова долгоруков
погода: погода
выступление: выступления
отделиться: отделились
шевелиться: шевелиться шевелились
тоскливый: тоскливо
сколько: сколько
твориться: творится
любопытство: любопытством любопытство любопытству
презрительный: презрительного презрительной
наклониться: наклонившуюся
грива: гривой
план: планы планом планов плана план планами
умный: умных
адрес: адресе
русский: русской русскими русский русских русским русского русская русские
десятый: десятом
ехать: ехавших ехал ехав ехать едет
борьба: борьба
шпага: шпаги
уехать: уехала уехал
один: одною одном одной одни одним одна одно одному один одних одного
видаться: видаясь
физический: физическое
вернуться: вернуться вернулась вернулись вернувшись
vii: vii
заморозка: заморозка
запереться: заперся
пропитать: пропитан
буксгевден: буксгевденом
доказывать: доказывавшими доказывал
бытность: бытность
большой: большом больше большое большой
быв: быв
занятие: занятиях занятии
морщина: морщинами
ноябрь: ноябре ноября
буйство: буйство
волос: волосами волосы волос
первый: первом первой первое первого первые первый
удобный: удобный
торопливость: торопливости
жалостный: жалостным
голова: головой головы голову
ворота: воротами ворота
квартальный: квартального
который: который которым которую которому которая которого которыми котором которой которых которое которые
больший: большим большая большую большие
произвести: произведет произведенном произвели
вперёд: вперед
этот: этот эти этих этой этому эту
губа: губой
жизнь: жизни жизнь
кроткий: кроткою
voilà: voilà
приехать: приехала приехал приехав приехать
радостный: радостное
государь: государю государь государи государя
день: дней дня дню днем дни день
ростов: ростова ростову ростовы ростов
человек: людьми люди людей человек человеком человека людям
ставить: ставившее
некоторый: некоторые
быстрый: быстр быстрые быстрейшее
xxiii: xxiii
грунт: грунт
ручка: ручками ручки
канонада: канонада
другой: другого другие другими другую другой других другою другому
четыре: четырех четыре
пробыть: пробывшего
благодать: благодать
подвигаться: подвигался
туманный: туманную туманная
родный: родными родных
успех: успеха
денщик: денщики
кверху: кверху
привычный: привычным привычных
столь: столь
михаил: михаиле
ланжерон: ланжерона
самоосуждение: самоосуждением
возможность: возможность возможности
любовь: любви любовь
тишина: тишина
делать: делали делала делать делал
полезный: полезен
девятый: девятом
река: реку река реках
деньга: денег деньги
девица: девица девицы
любить: любившей люблю
назначить: назначенный назначенного назначенному назначен назначенном
отрезать: отрезала отрезали
окровавленный: окровавленною
речь: речи речей речами
обить: обитую
министр: министру министра
смех: смеха
сидеть: сидел сидевшими сидели сидела
аустерлицкий: аустерлицкой аустерлицком
согреваться: согреваясь
прощальный: прощальный
глядеть: глядел глядя
отвечать: отвечала отвечать отвечает
весёлый: веселый веселого веселы веселые
особенность: особенности
сидя: сидя
вечер: вечера вечер
проведать: проведать
позвонить: позвонила
каждый: каждое каждой каждом каждый каждым
крайний: крайнего
карабинер: карабинерами
компаньонка: компаньонкой
раз: разу раз раза
неизведанный: неизведанное
англез: англезы англез
отчёт: отчета
атаковать: атакован атаковать
писание: писанием
николушко: николушка николушке
бонапартия: бонапартию
губернский: губернских
батарея: батарее батарей батарею батареи батарея
прекращаться: прекращались
задуматься: задумался
летать: летающий летавших
нога: ногами ног ногой ногу ноги
расшаркиваться: расшаркивающийся
скучно: скучно
высокий: высокой высокая высшей высшие высшем высокий
набожность: набожность
мещанский: мещанской
i: i
смотреть: смотреть смотря смотревшие смотрел смотрели
литься: лилась
забытый: забытой забыт
младший: младшая младшие
поверхностно: поверхностно
лоб: лоб лба лбу лбом
комната: комнатам комнате комнаты комнат комнату комнатах
суматоха: суматоху
выйти: вышла вышел вышли
последний: последний последнем последнее последней последние
генерал-аншеф: генерал-аншеф
лестница: лестнице лестницы
кремс: кремсе кремсу кремса
обманщик-немец: обманщика-немца
единовременный: единовременного
салоп: салопа
рада: рады
говор: говор говору
привезти: привезенный
заниматься: занимался
присутствие: присутствии
двор: двор
ход: ходе ходу
томить: томило
проясниться: прояснилась
старый: старые старому старый старой
противник: противника
поразить: поразило поразила
истекать: истекая
приказание: приказание приказанием приказания
обширный: обширному
мужчина: мужчинам мужчина мужчины
разбегаться: разбегались
допускать: допускаемый допускавший
удар: удар
вилья: вилье
подъехать: подъехал подъехали
немецкий: немецкой
показываться: показывался показывалась
сходить: сходил
поднять: поднят
мочь: могли может могла могущие мог
видеть: видели видела видеть видя видел
переехать: переехал переехав
наслаждение: наслаждения наслаждением наслаждение
наполеон: наполеоном наполеона наполеон
анекдот: анекдоты
причина: причина причины
ложа: ложу ложи ложе лож
девять: девять
толстый: толстым толстые толстыми
дама: дамами даму дама дамы
укладывать: укладывали
надевать: надевали надевающие надевал
представить: представить
сообщиться: сообщилось
деревня: деревни деревнях деревне деревню
предложение: предложения предложением
команда: командами
неподвижный: неподвижные
потому: потому
приезд: приезде приезд приезда
диспозиция: диспозиции
смешанный: смешанное
salut: salut
посредине: посредине
будущее: будущее
штаб-офицер: штаб-офицер штаб-офицера
тело: тело телом
вилларский: вилларский
наследник: наследником
котора: которою
случайность: случайности
екатерина: екатерины
огонь: огня огней
выехать: выехав выехал
соединиться: соединиться
располагаться: располагались
продолжать: продолжал
пустой: пустое
поездка: поездки
тащить: тащили
гора: гор горах горой гору горе горами горы
ладан: ладаном
фердинанд: фердинанда
выздоровление: выздоровления выздоровлению
задний: заднему заднего задней заднее
целый: целый целая целые
уважение: уважение
они: ими них им ними ним они их
восковой: восковая
четвёртый: четвертой четвертому
дорога: дорогу дороге дороги
тогда: тогда
войско: войска войсками войск войсках
кресло: кресла креслом креслу кресло кресле
пассаж: пассажи
верить: верить верили
мюрата: мюрата
выгнутый: выгнутой
прямота: прямотой
заплакать: заплакать
мысль: мыслей
бывший: бывших
дочь: дочерьми дочерью дочери
бросать: бросая бросали бросать
тихий: тихими тихим тихие
обстоятельство: обстоятельствам
отставка: отставке
собеседник: собеседника
дальний: дальний дальней
замечание: замечания
уверенный: уверен
следующий: следующий следующую следующему
истощённый: истощенным
разгораться: разгорались разгоралась
тот: теми тому том та тех того те той ту тот
табакерка: табакерок
застилать: застилавшими
приходить: приходить приходили приходивших
непременно: непременно
приятный: приятным приятный приятные
prusse: prusse
слева: слева
он: ему него нему он его
напоминать: напоминала напоминавших
стон: стоном стон
идти: шла шел шли шедшими идти
темнота: темнота темноту
свидание: свидания свидании
халат: халатах халате
попасть: попасть попала
казак: казаков казака казаки
иметь: имеющему имели имея имел имею имеешь
француз: французы французов французами
половина: половине половину
ночевать: ночевала
вздрогнуть: вздрогнул
поход: похода походе
горизонт: горизонте горизонт
стол: стола столу столе столом стол столы
движение: движению движением движение движениями
наблюдение: наблюдением
палата: палаты палатах
счастливый: счастливое счастливом счастлив счастливы
зачем: зачем
отделять: отделяло отделявшему
лазутчик: лазутчик лазутчика
андреевич: андреич андреевичу андреевича андреевич
dragon: dragon
муж: муже мужа муж
вы: вы вам вас вами
мундир: мундир мундира мундирах
восьмидесятитысячный: восьмидесятитысячной
отворяться: отворялась
надеяться: надеюсь
имение: именья имениям имениях имении имение имения
отпроситься: отпросился
отвести: отведенных отведена
глубоко: глубоко
закладывать: закладывать
графиня: графиня графини графине
преображенский: преображенскому
император: императора императоры император императору императоров императором
случайный: случайных
напряжённо: напряженно
точность: точности
приличный: приличные
подвязать: подвязанною
есть: есть ел
звать: звать
медвежий: медвежьих
кляча: кляче
женитьба: женитьбы
мертвец: мертвец
едва: едва
андрей: андрей андрея андрее андрею
источник: источника
xiii: xiii
начаться: началось началась
принадлежность: принадлежности
дремать: дремля
губерния: губернии губернию
сфера: сферы
неизвестно: неизвестно
лысый: лысых лысые
темно: темно
богемский: богемских богемские
мягко: мягко
отец: отец отцу отцом отца
болконский: болконского болконский болконскому
находчивый: находчив
фамильярный: фамильярен
лечь: лег
указ: указа
глаз: глазах глазам глазу глаза глаз глазами
синий: синих
корреспондент: корреспондента
прошедший: прошедшей
охранять: охранял
шёлковый: шелковыми
нагибаться: нагибаясь
обращаться: обращался обращаются
выпростать: выпростанными выпростаны
помочь: помогите
вести: вести ведшую
величественный: величественных величественная
затворить: затворенных затворив
отклонить: отклонить
родинка: родинка родинкой родинки
превосходный: превосходными превосходного
внушать: внушает внушал
командир: командиру командира командиры командиром
что-то: чем-то что-то
мало: мало
уездный: уездным
настлать: настланной
отставать: отстававшего
седой: седой
правый: правый правого правой правую правою
копошиться: копошилось
кругом: кругом
восемь: восемь
дмитриевич: дмитриевну
игра: игру
путешествие: путешествия
подъезжать: подъезжающих подъезжая подъезжали
ходить: ходивший ходили ходил
совершенный: совершенном совершенной
характер: характера
мыслия: мыслию
бумага: бумагами бумаги
шестой: шестой
хотеть: хотят хочет хотел
весь: вся всего всей весь всех всю всем всеми
храмина: храмин
коридор: коридор
передать: передан передал передав передано
самый: самая самых самый самые самое
известие: известием известий известие известия
единовременно: единовременно
проезжать: проезжали проезжающий
странный: странной
приподняться: приподнялись
уловить: уловить
класть: кладя
поехать: поехал поехали
намеренный: намерен
воспоминание: воспоминание воспоминаний воспоминания
секретарь: секретарем
флигель-адъютант: флигель-адъютант флигель-адъютанта
слух: слух
принимать: принимал принимать принимала
киев: киев
увидать: увидав увидать увидали
плен: плен плена
покраснеть: покраснел
дверь: дверями двери дверь дверей
банкет: банкете
готовиться: готовилось готовилась готовились
фланг: фланге фланг фланга
чёрный: черные черными черном
пять: пять
побывать: побывать
наступление: наступлении
состоять: состоял состоит состоявшие состояла
гофкригсрат: гофкригсрата гофкригсратом
секундант: секундант секунданты
борис: бориса борис
почитать: почитаю почитать
госпиталь: госпиталь
ветер: ветром ветер
город: город города
свеча: свеча свечой свечами
свой: свою своем своих своею своего своими свое своему свой свои своей своим
маленький: меньше маленькой маленькими маленький маленькая
оживиться: оживились
далеко: далеко
нависнуть: нависли
тянуться: тянулись
желанный: желанной
год: года год году
пятно: пятна
кирилл: кирилла кирилл кириллу
минута: минуту минуты
крик: крики криком криков крик
разносить: разносимый
ростовый: ростовым ростовых ростовой
военный: военному военный военной военного
камердинер: камердинером камердинер
эскадронный: эскадронным эскадронному
забавность: забавность
x: x
mon: mon
отличаться: отличавшаяся отличавшиеся
сильный: сильном сильного сильна
намерение: намерение
офицер: офицера офицером офицеру офицерами офицеры офицеров офицер
усиление: усиления
десятка: десятки
предводитель: предводителем
почтительный: почтительный
велеть: велел велела
прийти: пришедших пришло
пройти: прошли прошел пройдя прошло
куча: куче
точно: точно
солома: соломе соломой
рассеяться: рассеялся
полковой: полкового полковые
смутно: смутно
питать: питает
крестьянин: крестьян крестьянами
лафет: лафет
долох: долохов
езжать: езжали
нежно: нежно
распространиться: распространилось
карьера: карьеры карьеру
триста: триста
услыхать: услыхав услыхал
комитет: комитета комитетов
роды: родов
матвеевич: матвевны
граница: границам
горчаков: горчаковы
боевой: боевая
история: история
иогель: иогель иогеля иогелем
долженствовать: долженствовавшая долженствовавшие
спускать: спуская
кто: кем кто кого кому
перетолковывать: перетолковываемые
герой: герой
ловкий: ловкий
пяльцы: пяльцам пяльцами пяльцах
детский: детским
застегнуть: застегнутую
место: местам местах местом место месте места
требовать: требуя требуемыми
указательный: указательным
румяный: румяные румяный
ольмюцкий: ольмюцкое
важный: важных важном
слово: словам слова слове словами слово
познакомить: познакомил
спрятаться: спряталась
побежать: побежал побежала
бурьен: бурьен
рысью: рысью
княгиня: княгиней княгиня княгини
эрцгерцог: эрцгерцогом эрцгерцога
фрак: фраках фраке
павлоградский: павлоградского павлоградский
пристально: пристально
шаг: шагом шаги шагов шагах шагами
плохой: хуже
приложиться: приложусь
вникнуть: вникнуть
месяц: месяце месяца
странствие: странствие
гениальный: гениальным
спуск: спуске
инна: инне
поручение: поручение поручения
доехать: доедет доехавший
толпиться: толпились
газета: газетах газеты
почтительность: почтительности почтительность
храпение: храпению
обдумывать: обдумывал
довольно: довольно
проводить: проводил проводить
спокойно: спокойно
равный: равны
благоволение: благоволения
амштетен: амштетене
иванович: иванович ивановна ивановиче ивановичу
насквозь: насквозь
владимирович: владимировичу владимировича владимирович
особенно: особенно
обходить: обходили обходим
мгновение: мгновенье мгновение
беспрерывный: беспрерывных
совершаться: совершалось совершались
визит: визитов
сто: сто
остановиться: остановился остановились остановилась остановившееся
егерский: егерского
вчерашний: вчерашний вчерашнего
думаться: думалось
обоз: обозами обозы
выдвинуться: выдвинувшись
петербургский: петербургском петербургского петербургскому
помолюся: помолюся
сказать: сказала сказав сказал скажет сказали сказать
принять: приняла принята принять принял принят
никто: никому никто никого
заряд: заряды
бывать: бывает бывают бывал бывала
шалашик: шалашик
надгробный: надгробные
вход: входа
официантский: официантской
характерно-благородный: характерно-благородными
вообще: вообще
девочка: девочки девочек
terrible: terrible
праздность: праздность
известный: известна известному известные известное известным известны известных
глава: главе
прославлять: прославляли
приём: приема приемом
инстинкт: инстинкт инстинкту
павля: павле
домой: домой
читать: читать читая читавшей читала
помнить: помнит помни помните
вовлечь: вовлекла
звук: звуках звуки звук
зло: зла зло
припадок: припадкам
участвовать: участвовали участвовал участвовавших
проехать: проехала проехать проехали
поздравление: поздравлениями
iii: iii
ружейный: ружейные
это: этим этом этого
благоразумный: благоразумнее
совпадать: совпадал
слегка: слегка
нераненый: нераненые
оканчиваться: оканчивался
обыкновенный: обыкновенные
видеться: видеться виделся
находить: находя
крупный: крупными
брат: брата
зависеть: зависели зависит
сбегаться: сбегались
окружать: окружавшими окружавших окружавшим
больной: больнее больные больному больной
приказать: приказал приказано
сосна: сосну
перейти: перешедшими перейдя
xvii: xvii
род: рода
выстрел: выстрел выстрела выстрелы
скупой: скупы
прейсиш-эйлауский: прейсиш-эйлауского
четверо: четверо
руководство: руководством
артиллерия: артиллерия артиллерии артиллерией
чувствовать: чувствовал чувствовавший
враг: врага врагу
разделить: разделенную
marie: marie
дочесать: дочесать
надежда: надежды надежда надежду
немой: нем
март: марта
постройка: постройками
риза: ризами
пустыня: пустыня
марья: марья марьей
коляска: коляски коляске коляску
давно: давно
мост: мостом мост моста мосты мосту
проститься: простившись проститься
попарно: попарно
растворить: растворенными
эполет: эполет
очнуться: очнувшись
становиться: становилась становились становилось
конный: конные
двадцать: двадцати двадцать
фигура: фигуры фигура
adolescents: adolescents
замолчать: замолчи замолчали
xi: xi
танцевать: танцевать танцевали танцевавшие
дружба: дружбу
николай: николаю николаем николай николая
боль: боли
поспешный: поспешными
разложить: разложенным
случиться: случится
походка: походках походкой
сель: сели
трубка: трубок
упрёк: упреки
стратегия: стратегии
заискивать: заискивать
генерал: генералом генерала генералы генералов генералу
по-гусарски: по-гусарски
перехватить: перехваченным
одеяло: одеяла одеялом
перестрадать: перестрадавшего
никакой: никакого никаких
отдать: отдал
час: часам часу часов часа час
одежда: одежде одеждах
вещь: вещи
баркаролла: баркароллу
ужасно: ужасно
мрачный: мрачный
мак: маку мака
чистоплотный: чистоплотная
объехать: объехав
какой: каком какой каких каким какое
дождаться: дождавшись
преобразование: преобразования
гусарский: гусарский гусарского
вместе: вместе
брать: брал
анна: анны анною анна анной
талия: талией
опекунский: опекунским
петербург: петербург петербурга петербурге
потерять: потерял
легко: легко
скрываться: скрываясь
остановить: остановив остановлен
улыбнуться: улыбнувшееся
ружьё: ружей ружья
фамилия: фамилия
знакомый: знакомая знакомого знакомые знакомыми
воспользоваться: воспользовался воспользоваться воспользуются
вопросительно: вопросительно
проснуться: проснулся
редко: редко
белый: белыми белом белого
подушка: подушками подушках
интересовать: интересовать
успеть: успел успевшего успеет успевший
объявить: объявлено объявили
бедный: бедных
рассуждать: рассуждать
отказ: отказом
двое: двое
отступить: отступил
шить: шили
пространство: пространство пространству
гость: гостей гости гостями
назначение: назначение
сесть: сесть
спинка: спинкой
непреодолимый: непреодолимо
стена: стены стене
волостной: волостного
поддерживать: поддерживая поддерживал
приставлять: приставлял
левый: левом левый левую левого
кабинет: кабинет кабинета кабинете
вспотеть: вспотевших
анне: анне
присутствовать: присутствовать присутствовавших
интерес: интерес
глупый: глуп
молодцеватый: молодцеватый
десять: десяти
уезжать: уезжал
лицо: лицом лицу лицами лицо лицах лице лица лиц
записка: записку
смешливый: смешливого
взвод: взводом
открывать: открывал
пещера: пещерах пещер
письмо: письмо письмом письма
самоуверенный: самоуверенными
переносица: переносицу
испуг: испуге
пополнять: пополнял
сдержанно: сдержанно
взойти: взошла
внимательный: внимателен
неприятель: неприятелем неприятеля неприятелями неприятель
недалеко: недалеко
пудреный: пудреные
двигаться: двигаются двигалась двигались
сухарик: сухарики
оживляться: оживлялся
гражданский: гражданское
смотр: смотр смотра
тяжёлый: тяжелой тяжелом
партия: партии
открытый: открытую
михаилович: михайловны михайловне михайловна михайловной
невысокий: невысокая невысокий
илья: илья
денисов: денисова денисовым денисову денисов
доносить: доносил
противоположный: противоположной противоположным противоположном
приготовление: приготовления
трудный: трудные
красивый: красивым красивом красивый
право: правом права
какой-то: какая-то какие-то какое-то какого-то
поручик: поручик
стотысячный: стотысячною
спрятать: спрятала
твой: твоя
стремиться: стремился
доставать: доставали
возобновить: возобновивший возобновил
найти: нашла найдено найдет найти
лично: лично
ахросимов: ахросимову
русый: русые
нездоровье: нездоровья
отношение: отношении
длинный: длинными длинные длинною длинной длинное
выучить: выученные
определить: определен
ласка: лаской
екатерининский: екатерининским
осенний: осеннего
встретить: встретило встречен встретив встретила
выход: выходы выхода выходе
приезжать: приезжал приезжать приезжавшие
исключение: исключением исключения исключениями
оглядываться: оглядывался оглядываясь
способность: способность
кушать: кушать
зал: зала зале
покачивать: покачивал покачивая
живот: животе
костёр: костры костров
трескотня: трескотня
турецкий: турецких
спуститься: спустившихся спуститься спустился
согнутый: согнутая
составлять: составлявших составляли составлял
выражение: выражение выражения
удаться: удался удалось
настигнуть: настигнута
всякий: всякому всякую
знакомство: знакомства знакомстве
парадный: парадную
либеральный: либеральные
свежий: свежий свежих
светиться: светилась
бездействие: бездействии
граф: граф графом графа
кончить: кончила
середина: середине
прихоть: прихоти
ты: ты тобой тебе
наезжий: наезжая
свет: свете свет свету света
затемнить: затемненным
возиться: возиться
башмак: башмаках
шуточка: шуточками шуточки
нужный: нужным нужны нужные
встретиться: встретившийся встретилась встретившееся
возобновлять: возобновляя
прядь: прядями
слеза: слез
собственный: собственный собственную
разрешить: разрешен
уносить: уносимого
видный: видный виден видны
член: члены член членов
полтора: полтора
предвидеть: предвиденных предвидела
сделать: сделавший сделанному сделать
возвышение: возвышением возвышении
обратиться: обратилась обратился обратившись
причёска: прическу
ходатайство: ходатайства
зачумлённый: зачумленный
употребляться: употребляется
соборование: соборования
многоуважаемый: многоуважаемый
коллекция: коллекцию
той: тою
чарторижский: чарторижского
адъютант: адъютант адъютантами адъютанты адъютанта адъютантом адъютантов
квартира: квартира квартиру квартире
стонать: стонал
лес: леса лесу
закоптить: закопчены
поле: поле поля
женщина: женщинах женщины женщинами
правда: правду
небольшой: небольшое небольшая
вывалить: вывален
деятельность: деятельность деятельности
занятый: занят
акт: актов
третий: третьи третьею третий
нарушить: нарушило
vi: vi
xix: xix
неуловимый: неуловимая
встречаться: встречался встречаясь встречаться
убедиться: убедилась убедившись
васило: василья
разбудить: разбудил разбудила
выбрить: выбритый
армия: армия армией армию армии
желать: желая желал
навести: наведенная
опасаться: опасаясь
честь: честь
будущность: будущность
пехотный: пехотные пехотный пехотных
начинать: начинала начинайте начинать начинали начинал
оставить: оставлен оставить
гордый: гордая
ладонь: ладонью
неясно: неясно
спина: спине спиною
вспомниться: вспомнилась
александр: александр
xxi: xxi
знак: знаком знаку
молодой: молодые молодых молодой молодого
несвицкий: несвицкий
прислушиваться: прислушиваясь
равномерный: равномерное
серый: серыми серых
склянка: склянки
июнь: июня июне
снятой: снятых
поражение: поражении
предполагать: предполагал предполагают
дворец: дворец
много: много
шинель: шинелей шинель
расположение: расположении расположения
очень: очень
укрытый: укрытая
слезть: слезши
малый: малейшего меньшая малая
давать: давая давал давали
извещать: извещал извещавшего
бал: бале бал балы балах
необходимо: необходимо
хозяин: хозяина
коллежский: коллежских
начальство: начальством начальство начальства
долго: долго
асессор: асессоров
дым: дым дымом дыма дыму
жёлчь: желчь
устроивать: устроивал
распределять: распределял
бартенштейн: бартенштейна бартенштейне
дожидаться: дожидался
закон: законам
ступить: ступить
решить: решил решить
прошептать: прошептала
жаловаться: жалуясь
слуга: слуга слуг
билетик: билетики
чулок: чулках
заключаться: заключалась
мы: мы нами нас
кликнуть: кликнув
кружка: кружку кружках
улыбаться: улыбалась улыбаться улыбались
сослан: сослан
кучка: кучки
усталость: усталости
разговаривать: разговаривайте разговаривавших разговаривали разговаривая
тёмный: темными
шенграбен: шенграбен
разговор: разговоры разговором разговор разговорах
тут: тут
богатство: богатством
воплощаться: воплощались
неприступный: неприступная
кровь: кровь кровью
взятие: взятии
ариергардный: ариергардными
отступать: отступать отступая отступала
порок: пороков
ковёр: коврами
лето: лето
показывать: показывая
пролететь: пролетели
старание: стараниями
толпа: толпами толпы толпой толпа толпе
снизойти: снизойти
увидеть: увидели
тушин: тушину тушин
поворотить: поворотил
просьба: просьбе
ждать: ждать ждали
усиливаться: усиливающегося
мелькать: мелькали
друг: друга другу друг другом
оттого: оттого
предложить: предложил предложить
курьер: курьером
обдуманный: обдуманной
наконец: наконец
отцовский: отцовском
разъезд: разъездов разъезд
отпустить: отпустило
пьер: пьер пьеру пьере пьера пьером
поздороваться: поздоровался
xv: xv
оживить: оживлены
называть: называл
наезжать: наезжал
зуб: зубами
шкатулка: шкатулка
bonne: bonne
писать: писал
ничего: ничего
гостиная: гостиной
ответственность: ответственность
думать: думал думать думая
страдать: страдающим страдаю
прервать: прервала
бояться: боясь боялись
кавалерист: кавалеристов
серьёзно: серьезно
передавать: передавали
достигаться: достигались
подсыпать: подсыпали
фальшивить: фальшививших
охотницкий: охотницкую
уметь: умеешь умел
экипаж: экипажей экипажи
святой: святой
обвинять: обвиняли
апогей: апогея
посмеиваться: посмеивались
княжнина: княжниной
церковь: церкви
стараться: старался стараясь старались
центр: центре центра
рассказ: рассказы
рука: руку рукою руки руками рукой руках
хорошенький: хорошенькими хорошеньких хорошенькие
генерал-губернатор: генерал-губернатору
попроситься: попросился
уничтожать: уничтожая
случайно: случайно
устроить: устроить устроил
сновать: сновали
обозный: обозные обозным
решительный: решительным
лагерь: лагерем
завтрак: завтрака
раненый: раненые раненых
ежедневно: ежедневно
повар: повара
главнокомандующий: главнокомандующего главнокомандующий главнокомандующим главнокомандующему
парламентёр: парламентеры
дотронуться: дотронулась
сделаться: сделался сделалось
веселие: веселье
комиссия: комиссий
совсем: совсем
признаваться: признаваться
вид: вид видом виде
господин: господина
сливаться: сливаясь
укладка: укладку
условие: условий условиях условие условия
грозный: грозная
диванный: диванной
кучер: кучер
соня: соня
неизменно: неизменно
средство: средства
преодолеть: преодолеть
провести: провела провели провел
обед: обед обеда
театр: театр театра
пятнадцать: пятнадцати
передковый: передков
частый: чаще
недостаток: недостаток
такт: такту
английский: английского
обеспечить: обеспечила
наука: науки
ярко-зелёный: ярко-зеленым
улыбка: улыбкой улыбках улыбка улыбку
поздно: поздно
драться: дрались
билибино: билибина
раздражить: раздраженным раздражить
время: времени время
беспокоиться: беспокоясь
убивать: убивал
голенище: голенища
наставление: наставления
ласкать: ласкали
впервые: впервые
верный: верного
праценский: праценских праценской
благодетель: благодетель
оба: обе оба обеих
вглядываться: вглядывался вглядываясь вглядывались
чувство: чувство чувств чувства чувством
крестный: крестный
нынче: нынче
вниз: вниз
тёплый: теплых
спросить: спросить
мелька: мельке
иной: иные
объяснение: объяснения объяснением
орден: орденом орденами
миллион: миллионов
цепь: цепи цепь
ключ: ключи
покрикивать: покрикивая
замять: замято
путь: путь
облокотить: облокотив
подножка: подножки
российский: российской
увязывать: увязывали
переходить: переходили переходить
прятать: прятали
тон: тону тон
бешенство: бешенства
начинаться: начиналось
понять: понял
взволновать: взволнованным взволнован
заняться: заняться
фигурка: фигурка
бессонный: бессонной
рассчитывать: рассчитывать
оживлённый: оживленные оживленный оживленным
дюссекова: дюссековой
устать: уставшую устала
богатый: богат богатого
сопутствовать: сопутствуемый
сознание: сознание сознании сознания
артиллерист: артиллеристов артиллерист
раскрыть: раскрыт
икона: икон
девушка: девушке
союзник: союзникам
вслух: вслух
радушно: радушно
принудить: принужденным принужденная
преданность: преданность
стрелять: стрелять стреляли
доверять: доверяя
положение: положению положении положение
зазвучать: зазвучали
умереть: умер
чтение: чтение чтением
балаган: балаганов
укладываться: укладывался
устройство: устройство
пожелание: пожеланиями
изображать: изображавшего
повредить: повредил
поспешно: поспешно
прац: прац
тревога: тревога
махать: махая махали
плетёный: плетеный
война: войне войны война
обратить: обратил обратили
желание: желание
никак: никак
враждебно: враждебно
сила: силах силе силами силам
жить: жил жить
вспомнить: вспомнил вспомнить
кружиться: кружилась
прерывать: прерывал
официальный: официального официальным
болтливо-весёлый: болтливо-веселыми
страшный: страшное страшного
подняться: поднялась поднялся
садиться: садились
верхом: верхом
спускаться: спускались спускаться спускалось
кавалерийский: кавалерийской
шумно: шумно
возвратиться: возвратившись
торопливо: торопливо
сотня: сотни
течь: текла
вдалеке: вдалеке
заставать: заставал
приостановиться: приостановившись
изредка: изредка
близко: близко
сон: сон
капот: капотах
насупливаться: насупливался
произойти: происшедшем происшедшую произойти произошла произошло
масса: массы массе
xx: xx
сближение: сближениям
начальник: начальника начальники начальник
даль: даль
подсказывать: подсказывал
свежеть: свежей
редкий: редкими
шашка: шашка
дом: дома дом доме
входить: входил входя
резной: резным
усталый: усталые
продовольствие: продовольствия
обращение: обращения обращении
открыть: открыл
кровожадный: кровожадного
неопределённо: неопределенно
давка: давка
образ: образе образом образами
семейство: семейством
должный: должны должен должна
призывать: призываем
форма: форму
выходить: выходившие выходил выходила выходить выходили
изножие: изножья
пострадать: пострадали
ретирада: ретираду
молчание: молчание молчания
заботиться: заботился
морщиться: морщась
ротмистр: ротмистру
суеверие: суеверие
палец: пальцем палец пальцами
довольный: довольный
броситься: бросилась бросились
погубить: погубив
казаться: казалось казавшееся казались
сведение: сведения
заманчивый: заманчивым
объявление: объявлении
совершенство: совершенства
голос: голоса голосов голосами
впечатление: впечатлении впечатление впечатления
удовольствие: удовольствие
исповедь: исповедь
единственный: единственная
тринадцати-: тринадцати-
шомпол: шомполами
отряд: отряда отряд отряде
молча: молча
величие: величии
рыдать: рыдающим
узор: узоры
случай: случаев
рождество: рождества
геометрия: геометрии
торжок: торжке
iv: iv
зажечь: зажженными зажечь
долг: долгом
билибин: билибин
странница: странница
ранец: ранцы
поддаться: поддавшейся поддался
южный: южные южного
дунай: дунаю дунаем
разрешение: разрешения
взглянуть: взглянула
накопиться: накопившуюся
bourienne: bourienne
выздороветь: выздоровел
василий: василий василия
бежать: бежать
вставить: вставлена
вена: вене вену
смешаться: смешался
de: de
радость: радостью
вглядеться: вгляделся
сестра: сестер
сметь: смеет
одеяние: одеянии
усик: усиками
нужно: нужно
ныне: ныне
встревожить: встревожившие
уничтожение: уничтожении
крещение: крещенья
каменный: каменной
багратион: багратион багратиона багратиону
похороны: похороны
утром: утром
неаккуратный: неаккуратны
предшествовать: предшествующий
сначала: сначала
видимо: видимо
посетить: посетить
красить: красившая
почувствовать: почувствовал почувствовала
высота: высотах высот
я: мне я меня
тень: тени тень
достижение: достижения
фридландский: фридландское
гудеть: гудело
viii: viii
таинственный: таинственное
доставить: доставлена доставлен
прошедшее: прошедшего
мелкий: мелких мелкими
пойти: пойду пошел пойдет
разжаловать: разжалованным
оборот: оборотами
доверие: доверие
экземпляр: экземпляр
мужской: мужском
уверенность: уверенность уверенности
платок: платком платок
заря: заре
кавалерия: кавалерии
союзный: союзной
хорошенько: хорошенько
напудрить: напудренном напудренный
имя: именем
жадно: жадно
вербовать: вербовал
поколение: поколению
спрашивать: спрашивал
совет: совета совет
квадрат: квадрата
повод: поводу
le: le
подойти: подошедшая подошел
явственно: явственно
кровать: кровати кровать
масон: масонов
сухарь: сухари
музыкант: музыкантов
победа: победе
простота: простотой
доктор: доктора
гостиный: гостиных гостиную
четырнадцатилетний: четырнадцатилетние
подлинный: подлинных
махальный: махальный
выработаться: выработавшийся
снисходительно: снисходительно
сердце: сердце
слава: славу славы
строгость: строгость
жеркова: жеркова
относиться: относившейся относившиеся
себя: себя собой себе собою
совершать: совершаемых
венский: венский
ум: ум ума
широкий: широкими широким широкий
заметить: замеченным заметил
бровь: бровями
местопребывание: местопребывание
курагин: курагиным
ночлег: ночлега ночлегов
происходить: происходящего происходили
умирающий: умирающим умирающий
действовать: действовать
ещё: еще
близкий: ближе ближайших
внутренний: внутренняя
приобрести: приобрести
ii: ii
готовый: готов готовы
изменить: изменить
клонить: клонивший
котомка: котомкой
ненаглядный: ненаглядный
однообразный: однообразный
мир: мире мира
потребоваться: потребоваться
сад: саду
где: где
невольно: невольно
грациозность: грациозностью
отретироваться: отретироваться
рота: ротами роты
общество: обществе общества общество
повозка: повозки
перила: перилам
жестокий: жестоким жестокий
покрыть: покрытой
тотчас: тотчас
крюк: крюк
пролёт: пролете
детски: детски
пистолет: пистолета
лакей: лакеи лакей
двинуться: двинулся двинуться
скрыть: скрыть
преимущественно: преимущественно
очаков: очакова
надо: надо
парик: парике
старший: старшая старшей
подробно: подробно
сорок: сорок
слышаться: слышалась слышались
пух: пух
покой: покоях
дипломатический: дипломатическая дипломатического
михайл: михайла михайле
кивнуть: кивнул
взять: взявшую взяв взята
солнце: солнце
отчасти: отчасти
xvi: xvi
поменяться: поменялись
озабоченность: озабоченности
прелестный: прелестный
туман: тумана тумане
упасть: упал
наблюдать: наблюдая
солдат: солдаты солдат солдатами
ранить: ранен
прикладывать: прикладывая
постичь: постигшей
осуществляться: осуществлялись
линия: линию линии
различно: различно
печаль: печаль печали печалью
разбирать: разбирали разбирая
неожиданно: неожиданно
сапог: сапогах сапогами
коновязь: коновязь
дежурный: дежурному
воображение: воображении
незаконный: незаконным
колесо: колеса
отставить: отставленной
заглушать: заглушая
стул: стулья стулом
октябрь: октябре октября
значение: значение значения
строиться: строились
полка: полки полка
катишь: катишь
стучать: стуча
m-lle: m-lle
четвереть: четвертою
пояс: пояса
линц: линце
что: чего
васька: васьки
эскадрон: эскадрон эскадрона эскадроном
чепчик: чепчике
светский: светский
мила: мил
расстроенный: расстроеннее
три: трех три
мечтание: мечтания
крест: крест
завтра: завтра
решительность: решительность
заложить: заложив
ожидание: ожидания ожидание
туча: тучи
сторона: стороны сторону сторон стороною сторонам
коса: косы
обедать: обедал обедало
пробежать: пробежал
передок: передки
батальон: батальон батальону батальоны
подумать: подумал
позади: позади
boris: boris
поскакать: поскакал
дорожный: дорожные дорожный
молчать: молчать молчал
брюнна: брюнне
пятка: пятки
мазурка: мазурку
вчера: вчера
пособие: пособия
общественный: общественного
разойтись: разошлись разошелся
книга: книгой книги книгу
внизу: внизу
аудиенция: аудиенцию
соната: сонаты
хождение: хождение
более: более
тянуть: тянуло
овраг: овраг
лысогорский: лысогорского
драгоценный: драгоценная
причастие: причастие
там: там
льстить: льстил
свистения: свистения
далёкий: дальше
фланкёрский: фланкёрской
вступить: вступила вступил
близость: близость
нечего: нечего
здесь: здесь
устлать: устланной
бессловесный: бессловесному
отбиваться: отбиваясь
наш: наших нашего наши нашей
уничтожаться: уничтожались
обойти: обошел
ратник: ратники
коротко: коротко
получить: получил получив полученные
старушка: старушка
количество: количеству количества
отбежать: отбежали
братство: братство
считать: считал
склонить: склонив
помощь: помощью
перемена: перемена
цесаревич: цесаревичем
мучительный: мучительнейшая мучительна
село: села
топот: топот
старик: старика старикам стариков
нагнуться: нагнулась
присылать: присылал присылает
соображение: соображения
cher: cher
ничто: ничем
угодник: угодниками
тащиться: тащилось
развить: развить
несчастие: несчастие несчастию
изобличать: изобличал
рисковать: рисковал
невеста: невестам
павлоградец: павлоградцы
откровенный: откровенною откровеннее
исплакать: исплаканным
мрачно: мрачно
превосходство: превосходства
случаем: случаем
привозить: привозимых
ложный: ложные
увезти: увезти
захватить: захватив
пожимать: пожимал
посольство: посольства посольство
седа: седою
трубочка: трубочки трубочкой
вишау: вишау
составляться: составлялись
вновь: вновь
марь: марью
розыск: розыски
полковник: полковник
немного: немного
берг: берга
сейчас: сейчас
сдружиться: сдружился
старое: старого старое
работа: работой работа
забивать: забивали
зашевелиться: зашевелились
расположить: расположен расположенными
серебряный: серебряный
достойный: достойное
почтенный: почтенные
xii: xii
закрываться: закрывались
посторонний: постороннем
кратко: кратко
сухой: сухими
неразрешённый: неразрешенном
опять: опять
прижать: прижатый
управление: управления
поговорить: поговорить
выбежать: выбежали
браунау: браунау
щёлкать: щелкали
тесёмочка: тесемочками
потирать: потирал
выезжать: выезжал
дерево: дерева
престол: престол
испуганно: испуганно
xxv: xxv
налево: налево
беспрестанно: беспрестанно
еда: еду
часть: часть
клуб: клуба
войти: войдя вошел вошла
заодно: заодно
холодно: холодно
вольтеровский: вольтеровское
настроение: настроению
судебный: судебный
подарок: подарок
кадушка: кадушки
стойкость: стойкость
смеяться: смеющимся
элен: элен
pas: pas
мать: матери мать матерям
напирать: напирали
устав: устава
выслать: выслан
пропасть: пропали
получение: получения получении
обозначаться: обозначалось
явиться: явились явился
конченый: кончено
финансовый: финансовый
данный: данного
василь: василью
сзади: сзади
выкладка: выкладками
ротик: ротик
сутки: суток
действительно: действительно
бессмысленный: бессмысленное
пальба: пальбу
мода: моду
страдание: страданье
чиновник: чиновника чиновников
людской: людских
свита: свиту
незначительный: незначительный
нравственный: нравственное
появление: появления
напутствовать: напутствуемый
уж: уж
осмотреть: осмотрев
бесстрашие: бесстрашием
смотритель: смотритель
быстрота: быстрота
предвестник: предвестниками
страстно: страстно
правило: правилам
кемпийский: кемпийского
искать: искать
ревнивец: ревнивец
переменить: перемененными
персидский: персидскими
несколько: несколько
подзывать: подзывая
ошибаться: ошибаюсь
добродетель: добродетели
креститься: крестился крестились
давнишний: давнишнее
плешивый: плешивую
всегда: всегда
красно-жёлтый: красно-желтом
жена: женой
навстречу: навстречу
горло: горло
шапка: шапках шапки
жених: женихов женихом
страх: страха страх
различие: различия
подражать: подражая
догнать: догнал
подать: подать
поцеловать: поцеловал поцеловала
наташа: наташа
немедленно: немедленно
окружить: окружила
портрет: портретом
подъезд: подъезда подъезду
неловко: неловко
пчела: пчелы
степень: степени
долоховый: долоховым
честной: честного
переносить: переносить
праца: працу праца
карета: карета кареты
весенний: весеннем
сходиться: сходились
дипломат: дипломата
действительность: действительность
медленно-торжественно: медленно-торжественно
проговорить: проговорил
осуществить: осуществить
защищать: защищать
испытывать: испытывал испытывая
ведро: ведрами
непосвящённый: непосвященных
прижаться: прижались
разглядеть: разглядел
громко: громко
устремить: устремленным
вытянуться: вытянувшийся
напрасно: напрасно
рана: раны
амфилохия: амфилохия
сближаться: сближался
исполнить: исполнил
архитектор: архитектор архитекторе
танцор: танцор
никогда: никогда
вверх: вверх
начальствовать: начальствовавшего
обычный: обычное
связь: связь
разбитый: разбиты
качество: качестве
превосходить: превосходившим
передовой: передовою
состояние: состояния состоянии состояний
сморкаться: сморкавшемся
свойственный: свойственному
поставить: поставленных
хотеться: хотелось хочется
голосок: голоску
рязанский: рязанского
v: v
статский: статских
крыльцо: крыльца крыльцо
неподвижно: неподвижно
привычка: привычке привычку
целое: целого
подольский: подольского
круглый: круглым
знамя: знамени
спасть: спал
узкий: узкой
удалиться: удалиться
что-нибудь: что-нибудь
математика: математики
главное: главное
чуть: чуть
аванпост: аванпостах
радостно: радостно
масонство: масонства
расходиться: расходились
полдень: полудня
долетать: долетали
успокоиться: успокоилась
плевать: плевал
садовник: садовник
сдержанность: сдержанности
тушино: тушина
баталия: баталий
уже: уже
хозяйка: хозяйки
привести: привести
щека: щекам щек
зачисление: зачислении
неприличность: неприличности
командуть: командуемую
провожать: провожает
обманщик: обманщиков
каре: каре
игрок: игроков
рассказывать: рассказывали рассказывала
порывистый: порывистой
топнуть: топнув
тяжесть: тяжестями тяжестей
неизменный: неизменных
станция: станции
звучать: звучал
ранний: раньше
монах: монахи
вейротёр: вейротера
расстояние: расстоянию
клетчатый: клетчатый
отличиться: отличится
нежный: нежную
постой: постоем
юнкер: юнкер юнкером
рот: рот
почесть: почестями
тяжело: тяжело
ножка: ножкой
павлович: павловна
даром: даром
большинство: большинство
заманить: заманить
готовить: готовили
храбрость: храбрость
старательно: старательно
рассыпать: рассыпаны
шерстинка: шерстинку
красный: красного красно
воротиться: воротились
перебивать: перебивая
франц: франц францу
точение: точением
справа: справа
уныло: уныло
чин: чинов чины
огонёк: огоньки
лента: лентой
полок: полком полков
энс: энс
слышать: слышал
пропустить: пропустить
признавать: признавали признаваемую
прозвать: прозванную
советник: советников
переставать: переставали
приобретение: приобретении
мемуары: мемуаров
смешиваться: смешиваясь
виднеться: видневшаяся
выражать: выражало
стих: стих
выпрастывать: выпрастывая
пустить: пустили
вдруг: вдруг
ix: ix
разъездной: разъездных
связывание: связыванье
станок: станке
назад: назад
древко: древком
различный: различные различных
кто-нибудь: кому-нибудь
цветочный: цветочной
скоро: скоро
неприятельский: неприятельские
делаться: делалось делался
экосез: экосезы
вверху: вверху
отыскивать: отыскивать
громкий: громче
пребывание: пребывания
гость-мужчина: гостей-мужчин
участь: участи
очевидный: очевидно
иногда: иногда
смешной: смешон смешных
выздоравливать: выздоравливающий
участие: участие
туда: туда
площадь: площади
местность: местности местность
красноречивый: красноречив
совершенно: совершенно
громадно-высокий: громадно-высокая
тысяча: тысяч тысячей
распоряжаться: распоряжался
нетерпение: нетерпение
федя: феде
остальной: остальная
стоянка: стоянки
безвыходный: безвыходное
втихомолку: втихомолку
польский: польский
воспалить: воспаленных
шесть: шести
склад: склад
недостижимый: недостижимая
хорошо: хорошо
въехать: въехала
roi: roi
алексеевич: алексеевичем
отбросить: отбросить
подниматься: подниматься поднимавшейся
покровительственно: покровительственно
оглянуться: оглянется
твёрдый: твердыми
лев: льва
помощник: помощников
неясный: неясные
столовая: столовые столовую
ламбах: ламбахе
экзамен: экзаменах
посмотреть: посмотрела
вылететь: вылетело
du: du
пережёвывать: пережевывали
высказывать: высказывал
мучить: мучила
застать: застала
будущий: будущая
занимать: занимали
воля: воле
край: края
перемирие: перемирие перемирием
припомадить: припомажены
втрое: втрое
веселиться: веселиться
платье: платья
прекрасный: прекрасное прекрасные
отдавать: отдавали отдавал
взгляд: взглядом
описывать: описывал
оттенок: оттенком
парадное: парадному
воинский: воинского
сажный: сажен
откланяться: откланявшись
спокойствие: спокойствия
столица: столицы
пункт: пункт
ульм: ульмом
отойти: отошел
женить: женить
милый: милый
па: па
застигнуть: застигнутые
удивление: удивления
велено: велено
атака: атака
долохов: долохова
энергия: энергии
стекаться: стекались
вечерний: вечерней
шутя: шутя
передний: переднего
чемодан: чемоданов
погонять: погонял
нести: нести
отъезд: отъезда
зима: зимы
милорадовичевский: милорадовичевской
лишний: лишнее
сумка: сумок
adolescentes: adolescentes
начать: начали
дуэль: дуэлей дуэли
худой: худой
ласковый: ласковым ласков
показать: показать показали
дробь: дробь
бодро: бодро
медведь: медведем
забавный: забавные
отсутствие: отсутствие
воронка: воронкой
требовательный: требователен
суконный: суконных
весьма: весьма
приличие: приличия
завязать: завязано
упад: упаду
должность: должности
вскоре: вскоре
плечо: плечами
оттуда: оттуда
решиться: решился решилась
добродушный: добродушный
выбегать: выбегали
осип: осипом
бог: бога
отягощать: отягощая
спутник: спутнику
товарищ: товарища
составиться: составились
разместиться: разместились
графа: графу
вечером: вечером
происшествие: происшествий
установиться: установившиеся
сбить: сбили
добежать: добежала
требование: требование
декабрь: декабре
смешанно: смешанно
наступательный: наступательной
xxii: xxii
низко: низко
братский: братской
красота: красота
подтвердить: подтвержденная
настоящий: настоящего
тогдашний: тогдашнюю
глазок: глазки
пользоваться: пользоваться
выдача: выдачу
судьба: судьба судьбы
кафтан: кафтанах
полуторастатысячный: полуторастатысячная
россия: россии
устроенный: устроенный
написать: написано написанным
грубость: грубостью
принести: принесшей
всепрощение: всепрощением
вступать: вступали
одеться: одевшись
убить: убьют
нездоровый: нездоров
вбежать: вбежали
потребовать: потребованы
язык: языке
швейцар: швейцару
дойти: дошел
человеческий: человеческого
посвятить: посвященных
чувствительный: чувствительную чувствительнее
киевский: киевскую
известить: известил
танцовывалить: танцовывали
упускать: упускать
дрова: дрова
сцена: сценой
брак: брака
изменять: изменяя
легион: легиона
особенный: особенного
заснуть: заснул
анатоль: анатоль анатоля
прямо: прямо
четверть: четверть
приближаться: приближался
проклятие: проклятия
строганов: строганова
пуговица: пуговицу
спокойный: спокойным спокойную
стрельба: стрельба
рожков: рожков
книзу: книзу
невестка: невестка
придерживать: придерживал
discrétion: discrétion
направиться: направились
весело: весело
ипполит: ипполитом ипполит
очки: очки
впереди: впереди
деятель: деятель
входящий: входящую
заслышаться: заслышались
чай: чай
бостонный: бостонные
погибель: погибели
завтракать: завтракали
административный: административный
рассказать: рассказал
урок: уроки
проситься: просилось
средина: средине
ступать: ступая
въезд: въезд
востороженно: востороженно
ночной: ночного
стройный: стройного
преодолевать: преодолевал
ланна: ланна
шалаш: шалаша
бестолковый: бестолковый
душа: душу
разрыв: разрывом
неторопливо: неторопливо
сбор: сборы
верхами: верхами
безвыездно: безвыездно
поспешность: поспешности
прижимать: прижимали
„поехать: „поезжай
смять: смятыми
черта: черта
запрягать: запрягали
избежать: избежавшие
жениться: жениться
пржебышевский: пржебышевского
пехота: пехоты пехота
пленный: пленных
настоять: настояв
висячий: висячими
блестящий: блестящей блестящих блестящие
только: только
последствие: последствием
останавливаться: останавливаясь
цыпочки: цыпочках
кочубей: кочубея
выдержать: выдержать
сорокатысячный: сорокатысячную
чехол: чехлах
окно: окнами
накануне: накануне
châle: châle
битва: битве
уйти: ушел
видать: видала видал
миля: милях
колонновожатый: колонновожатые
разноречивый: разноречивые
постель: постель
кампания: кампанию
усвоить: усвоила
зальценек: зальценек
почётный: почетного
перестать: перестал
—: —
хрипеть: хрипел
кадка: кадок
подобный: подобное
яркий: яркое
нельзя: нельзя
подписать: подписаны
чужой: чужих
заходить: заходил
часто: часто
изнурённый: изнуренную
дурно: дурно
постоянно: постоянно
молодёжь: молодежи
смеючиться: смеючись
возвращаться: возвращаясь
ливрейный: ливрейные
ужин: ужин
жужжание: жужжанья
стратегический: стратегический
путаться: путались
учтивость: учтивостью
кутузовский: кутузовская
заколыхаться: заколыхались
пудра: пудре
сорт: сортов
разнородный: разнородные
предупредить: предупрежденным
вызвать: вызванную
нет: нет
дивизия: дивизии
заехать: заехать
азовский: азовского
диван: дивана диван
цель: цель
рассеянность: рассеянности
резка: резок
нынешний: нынешний
действие: действие
взволнованно: взволнованно
чернеться: чернелось
amie: amie
угол: углу
библиотека: библиотеке
сбираться: сбиралась
бить: бил
гореть: горевших
матушка: матушка матушки
отбивать: отбивали
злобный: злобным
апрель: апреле
закричать: закричал
конец: конце
раздеваться: раздеваясь
согласиться: согласиться
лейб-медик: лейб-медик
менее: менее
пахнуть: пахло
comité: comité
защищаться: защищаясь
указывать: указывая
строгий: строгая
поднимать: поднимая
занавес: занавесами
наслать: нашли
остаток: остатки
самоосмеяние: самоосмеянием
учтивый: учтивого
вельможа: вельможей
уведомление: уведомления
петергоф: петергофе
утешительный: утешительными
тушить: тушили
уходить: уходили
спать: спит
золовка: золовки
крепость: крепости
полтораста: полтораста
закусить: закушенной
проскакать: проскакали
приёмный: приемной
снежно-белый: снежно-белыми
гробовщик: гробовщики
исполнение: исполнение
потом: потом
мой: мой
существующий: существующий
услуга: услуги
щуриться: щурясь
протянуть: протянула
глухой: глухая
раздвинуть: раздвинули
xviii: xviii
отступление: отступление
охать: охая
киот: киота киот
теперь: теперь
житель: жителями жителей
замуж: замуж
снизу: снизу
волосик: волосиками
мешочек: мешочки
разделять: разделяет
полюбить: полюбившая
предлагать: предлагая
скучливый: скучливое
почти: почти
ездить: ездил
быстро: быстро
живо: живо
нетрудно: нетрудно
подверженный: подверженный
озлобление: озлоблению
василить: васильем
кое-кто: кое-кто
сильно: сильно
xxiv: xxiv
корпус: корпуса
удивляться: удивляясь
стоя: стоя
дышать: дыша
семёновский: семеновским
перст: персты
разгласиться: разгласилась
убитый: убитых
останавливать: останавливало
случаться: случалось
воздух: воздух
дымка: дымок
полк: полк
переворот: переворотов
взрослый: взрослые
трауна: трауне
всюду: всюду
просить: просить
существование: существовании
манифест: манифест
колпак: колпаке
трудно: трудно
ярко: ярко
виться: вились
тихо: тихо
ухо: уши
нехорошо: нехорошо
добиться: добиться
деятельный: деятельной
изменяемый: изменяемая
держаться: державшийся
бесчисленный: бесчисленному
сбегать: сбегали
твёрдо: твердо
повторять: повторяемые
выделывать: выделывающих
утро: утра
рекрут: рекруты
остаться: остался
забота: заботами
новосильцев: новосильцева
ввести: ввел
фельдшер: фельдшер
уединённый: уединенной
терять: теряя
выскочить: выскочил
где-нибудь: где-нибудь
преследовать: преследуемая
беспокойный: беспокойное
империя: империи
грудь: грудью
удерживаться: удерживаясь
кланяться: кланяться
май: мая
чисто: чисто
ma: ma
охватить: охватили
официант: официанты
официально: официально
кое-где: кое-где
отказаться: отказался
чувствоваться: чувствовалась
фома: фомы
застёгиваться: застегивались
предстоящий: предстоящей
встречать: встречаемая
жерковы: жерков
ученица: ученицы
аркольский: аркольского
конституция: конституция
вдали: вдали
вейротереть: вейротер
сереться: серелось
командный: командные
никуда: никуда
служба: службы
часовой: часовой
выбрать: выбрать
влюбить: влюбленный
робкий: робким
